Nordafrika: Brasilien, Aegypten, Ostafrika, Congo, Westeuropa, Suedeuropa
Brasilien: Nordafrika, Argentinien, Peru, Venezuela
China: Mongolei, Suedostasien, Indien, Sibirien, Afghanistan, Ural
Mittlerer-Osten: Indien, Afghanistan, Ostafrika, Aegypten, Suedeuropa, Russland
Ostafrika: Mittlerer-Osten, Aegypten, Nordafrika, Kongo, Suedafrika, Madagaskar
Suedafrika: Madagaskar, Ostafrika, Kongo
Russland: Skandinavien, Nordeuropa, Suedeuropa, Mittlerer-Osten, Afghanistan, Ural
Indien: Mittlerer-Osten, Afghanistan, China, Suedostasien
Oststaaten: Ostkanada, Ontario, Weststaaten, Mittelamerika
Ostaustralien: Neuguinea, Westaustralien
Afghanistan: Russland, Mittlerer-Osten, Indien, China, Ural
Zentralafrika: Ostafrika, Nordafrika, Suedafrika
Weststaaten: Alberta, Ontario, Oststaaten, Mittelamerika
Mongolei: Japan, Kamtschatka, Irkutsk, Sibirien, China
Argentinien: Peru, Brasilien
Westaustralien: Indonesien, Neuguinea, Ostaustralien
Nordwest-Territorium: Alaska, Groenland, Alberta, Ontario
Jakutien: Sibirien, Irkutsk, Kamtschatka
Peru: Argentinien, Brasilien, Venezuela
Ural: Sibirien, China, Afghanistan, Russland
Aegypten: Suedeuropa, Mittlerer Osten, Ostafrika, Nordafrika
Kamtschatka: Yakutsk, Irkutsk, Mongolei, Japan, Alaska
Mittelamerika: Weststaaten, Oststaaten, Venezuela
Venezuela: Mittelamerika, Brasilien, Peru
Sibirien: Ural, China, Mongolei, Irkutsk, Yakutsk
Groenland: Nordwest-Territorium, Ontario, Ostkanada, Island
Alberta: Alaska, Ontario, Weststaaten
Irkutsk: Yakutsk, Sibirien, Mongolei, Kamtschatka
Suedostasien: China, Indien, Indonesien
Indonesien: Suedostasien, Neuguinea, Westaustralien
Ostkanada: Groenland, Ontario, Oststaaten
Alaska: Nordwest-Territorium, Alberta, Kamtschatka
Ontario: Alberta, Nordwest-Territorium, Groenland, Ostkanada, Oststaaten, Weststaaten
Suedeuropa: Russland, Mittlerer-Osten, Aegypten, Nordafrika, Westeuropa, Nordeuropa
Westeuropa: Grossbritannien, Nordeuropa, Suedeuropa, Nordafrika
Skandinavien: Island, Grossbritannien, Nordeuropa, Russland
Nordeuropa: Skandinavien, Russland, Suedeuropa, Westeuropa, Grossbritannien
Neuguinea: Indonesien, Westaustralien, Ostaustralien
Madagaskar: Suedafrika, Ostafrika
Japan: Kamtschatka, Mongolei
Grossbritannien: Island, Skandinavien, Nordeuropa, Westeuropa
Island: Groenland, Skandinavien, Grossbritannien
